NO      ./textures/north.xpm
SO      ./textures/south.xpm
WE      ./textures/west.xpm
EA     ./textures/et.xpm

F 200,100,0
C 227,30,2

111111
100001
101001
1000N1
111111