NO ./textures/north.xpm
SO ./textures/south.xpm
WE ./textures/west.xpm
EA ./textures/east.xpm

F 201, 100, 0
C 227,30,2


1111111
  11101
111011
101E11
111111
