
NO  ./textures/north.png
EA  ./textures/east.png
WE  ./textures/west.png 
SO  ./textures/south.png

F  16, 55, 255 
C 45, 5, 44


   11111111111111111
111 10000000000001
10111111000000001
10010001001000001
10010001011000001
10000110001N00000111
10110000000000001
10110001000000001
10110000100000001
10001110110000001
10001110110000001
10001110110000001
10001110110000001
10001110110000001
10001110110000001
11111111111111111