NO  ./textures/north.png
SO  ./textures/south.png
EA  ./textures/east.png
WE  ./textures/west.png

F 14,4,22
C 43,5,44  


11111111111111111
10000000000000001
10111111000000001
10010001001000001
10010001011000001
10000001000000111
11000000011100001
10110010000000001
10110000000010001
10001110111111111
1011000000000N001
10001110110000001
10001110110000001
10001110110000001
10001110110000001
10001110110000001
10001110110000001
10001110110000001
10001110110000001
10001110110000001
10001110110000001
10001110110000001
10001110110000001
10001110110000001
10001110110000001
10001110110000001
10001110110000001
10001110110000001
10001110110000001
10001110110000001
10001110110000001
10001110110000001
10001110110000001
10001110110000001
10001110110000001
10001110110000001
10001110110000001
10001110110000001
10001110110000001
10001110110000001
10001110110000001
10001110110000001
10001110110000001
10001110110000001
10001110110000001
10001110110000001
10001110110000001
10001110110000001
10001110110000001
10001110110000001
10001110110000001
10001110110000001
10001110110000001
10001110110000001
10001110110000001
10001110110000001
10001110110000001
10001110110000001
10001110110000001
10001110110000001
10001110110000001
10001110110000001
10001110110000001
10001110110000001
10001110110000001
10001110110000001
10001110110000001
10001110110000001
10001110110000001
10001110110000001
10001110110000001
10001110110000001
10001110110000001
10001110110000001
10001110110000001
10001110110000001
10001110110000001
10001110110000001
10001110110000001
10001110110000001
10001110110000001
10001110110000001
10001110110000001
10001110110000001
10001110110000001
10001110110000001
10001110110000001
10001110110000001
10001110110000001
10001110110000001
11111111111111111