NO   ./textures/north.png
SO  ./textures/south.png
EA  ./textures/east.png
WE  ./textures/west.png

F 14,4,22
C 43,5,44  


111111111111111111111111111111
111111111111111111111111111111
110000000000000000000000000011
110000000000000N00000000000011
110011111111111111111111110011
110000000000000000000000000011
110000100000100000100000100011
110000100000100000100000100011
110011111111111111111111110011
110000100000100000100000100011
110000100000100000100000100011
110000100000100000100000100011
110011111111111111111111110011
110000100000100000100000100011
110000100000101000100000100011
110000100000100000100000100011
110011111111111111111111110011
110000100000100000100000100011
110000100000100000100000100011
110000100000100000100000100011
110011111111111111111111110011
110000100000100000100000100011
110000100000100000100000100011
110000100000100000100000100011
110011111111111111111111110011
110000100000100000100000100011
110000000000000000000000000011
110000000000000000000000000011
111111111111111111111111111111
111111111111111111111111111111
