
NO  ./textures/north.png
EA  ./textures/east.png
WE  ./textures/west.png 
SO  ./textures/south.png

C  135, 206, 131
F 119, 119, 2



11111111111111111
11111111111111111
111 10000000000001
11111111000000001
1E010001001000001
10010001011000001
 1000110001000001
10110000000000001
11001111111111111
  11              101 
11111111111111111
11111111111111111
10110001000000001
10110000100000001
10001110110000001
10001110110000011
10001 10110100001
10001110110000001
10001110110000001
10001110110000001
11111111111111111