NO textures/north.png
SO textures/south.png
WE textures/west.png
EA textures/east.png

C 0, 153, 153
F 64, 64, 64

11111111111111111
11111111111111111
111 10000000000001
11111111000000001
10010001001000001
10010001011000001
 1000110E01000001
10110000000000001
11001111111111111
  11             1 
11111111111111111
11111111111111111
10110001000000001
10110000100000001
10001110110000001
10001110110000011
10001 10110100001
10001110110000001
10001110110000001
10001110110000001
11111111111111111