NO  ./textures/north.xpm
SO  ./textures/south.xpm
EA  ./textures/east.xpm
WE  ./textures/west.xpm




1111111111 11111111111111
1000000001 10000000111111
1000000000100000000000001
1000000000100000000000001
10000000011N0000000000001
100000001 10000110000001
11111111 111111 11111111
1111111111 11111111111111
1000000001 10000000111111
1000000000100000000000001
1000000000100000000000001
1000000001100000000000001
100000001 10000110000001
11111111 111111 11111111