NO textures/north.png
SO textures/south.png
WE textures/west.png
EA textures/east.png

F 20,20,20
C 200,200,200

11111
10101
10101
10101
10101
10101
1E111
11111