NO textures/north.png
SO textures/south.png
WE textures/west.png
EA textures/east.png

F 20,20,50
C 200,180,230

1111111111111
1010000000001
1010000001111
1010000111111
1111111111111
			111	
1111111111111
1010000111111
1010000111111
1E00000111111
1111111111111